AACGTGAT	AACGTGAT
AAACATCG	AAACATCG
ATGCCTAA	ATGCCTAA
AGTGGTCA	AGTGGTCA
ACCACTGT	ACCACTGT
ACATTGGC	ACATTGGC
CAGATCTG	CAGATCTG
CATCAAGT	CATCAAGT
CGCTGATC	CGCTGATC
ACAAGCTA	ACAAGCTA
CTGTAGCC	CTGTAGCC
AGTACAAG	AGTACAAG
AACAACCA	AACAACCA
AACCGAGA	AACCGAGA
AACGCTTA	AACGCTTA
AAGACGGA	AAGACGGA
AAGGTACA	AAGGTACA
ACACAGAA	ACACAGAA
ACAGCAGA	ACAGCAGA
ACCTCCAA	ACCTCCAA
ACGCTCGA	ACGCTCGA
ACGTATCA	ACGTATCA
ACTATGCA	ACTATGCA
AGAGTCAA	AGAGTCAA
AGATCGCA	AGATCGCA
AGCAGGAA	AGCAGGAA
AGTCACTA	AGTCACTA
ATCCTGTA	ATCCTGTA
ATTGAGGA	ATTGAGGA
CAACCACA	CAACCACA
GACTAGTA	GACTAGTA
CAATGGAA	CAATGGAA
CACTTCGA	CACTTCGA
CAGCGTTA	CAGCGTTA
CATACCAA	CATACCAA
CCAGTTCA	CCAGTTCA
CCGAAGTA	CCGAAGTA
CCGTGAGA	CCGTGAGA
CCTCCTGA	CCTCCTGA
CGAACTTA	CGAACTTA
CGACTGGA	CGACTGGA
CGCATACA	CGCATACA
CTCAATGA	CTCAATGA
CTGAGCCA	CTGAGCCA
CTGGCATA	CTGGCATA
GAATCTGA	GAATCTGA
CAAGACTA	CAAGACTA
GAGCTGAA	GAGCTGAA
GATAGACA	GATAGACA
GCCACATA	GCCACATA
GCGAGTAA	GCGAGTAA
GCTAACGA	GCTAACGA
GCTCGGTA	GCTCGGTA
GGAGAACA	GGAGAACA
GGTGCGAA	GGTGCGAA
GTACGCAA	GTACGCAA
GTCGTAGA	GTCGTAGA
GTCTGTCA	GTCTGTCA
GTGTTCTA	GTGTTCTA
TAGGATGA	TAGGATGA
TATCAGCA	TATCAGCA
TCCGTCTA	TCCGTCTA
TCTTCACA	TCTTCACA
TGAAGAGA	TGAAGAGA
TGGAACAA	TGGAACAA
TGGCTTCA	TGGCTTCA
TGGTGGTA	TGGTGGTA
TTCACGCA	TTCACGCA
AACTCACC	AACTCACC
AAGAGATC	AAGAGATC
AAGGACAC	AAGGACAC
AATCCGTC	AATCCGTC
AATGTTGC	AATGTTGC
ACACGACC	ACACGACC
ACAGATTC	ACAGATTC
AGATGTAC	AGATGTAC
AGCACCTC	AGCACCTC
AGCCATGC	AGCCATGC
AGGCTAAC	AGGCTAAC
ATAGCGAC	ATAGCGAC
ATCATTCC	ATCATTCC
ATTGGCTC	ATTGGCTC
CAAGGAGC	CAAGGAGC
CACCTTAC	CACCTTAC
CCATCCTC	CCATCCTC
CCGACAAC	CCGACAAC
CCTAATCC	CCTAATCC
CCTCTATC	CCTCTATC
CGACACAC	CGACACAC
CGGATTGC	CGGATTGC
CTAAGGTC	CTAAGGTC
GAACAGGC	GAACAGGC
GACAGTGC	GACAGTGC
GAGTTAGC	GAGTTAGC
GATGAATC	GATGAATC
GCCAAGAC	GCCAAGAC
